a        lot!	lyɛ̄mɛ̄mɛ̄!
A week later!	Obri̍īhī yī nū wā ge̍ grāa1
also!        	titi!
always       	Myɛ̄grāa-myɛ̄grāa
ancestors   	ɔ̍kɔ̄kū
and         	ba̍la 
and you     	bal̍ a wɔ
angels      	Ɔyɛ̍ɛ̄chɛ̄rɔ̄  yī Ɔwɔ 
another     	ɔha̍
another place	ɛbɛha̍ 
another time 	Yɛ̄grāa ɔha̍
answer       	hīya  ɔkɔ
answer her   	hīya anu̍ ɔkɔ
Anywhere at all 	ba̍la ɛbɛha̍-ɛbɛha̍ wa̍a̍
we are still going to	Alɔ ge̍ē gba̍a
arrived 	gbajɛ
as his going to do  	 lɔkɔ nīi o̍ ge̍ē ya̍ ma̍
at that point	"Bū la ɛbɛ ɔla̍ā,"
back	ihi
bad thing	lɛlā ɔdwɔ̄bi̍ 
bag 	liba
bamboo  	ͻkpͻkpͻ
baptised people 	hu āchɛ yenyi
baptism	hu  yenyi
basket  	oblibli
be alert	"kū grigri,"
answer him  	hīya anu̍ ɔkɔ
answer them 	hīya aa̍ ɔkɔ
Any time	yɛḡ rāa ɔhal̍ ɔha
shepherd	odeyīrɛ anyīyɛrɔ̄
went first  	yɔbɔ̄ɔbū
Be confident	Tū ūkpɔ̄tū
Abijah was the father of Asa	A̍bīja ma A̍sa
Abraham was the father of Isaac 	A̍brahāam ma A̍yi̍sāaki
too many	yɛ̍ɛ̄mɛ̄mɛ̄
afraid  	tūuhwi
After he has said that  	O̍ de ka i̍ngɔ̍ɔ bɛ̍ɛ̄nɛ̄ ma̍
After the day of rest had finished  	Ɔ̄chī Ɔmyɛ̍nyɛ̍ wā ge̍ kwɛ̍ɛjī ma̍
After this	La okwi̍ihi yī ɔla̍ā
All this happened there 	Lɛlā nūma̍ wa̍a̍ ya̍ abɔ̍ɔ
all this things 	Ɛjā nūma̍ wa̍a̍
anyone that want peace  	Ɔ̄chɛ nīi chikpo̍ yī ogbodɔ̍dɔ̍ ma̍
anything that girl want 	ɔjā-mɔjā nīi ɔyi̍ ɔnɔ̄nyā ɔla̍ā  ge̍ chikpo̍
anything the girl want  	ɔjā-mɔjā nīi ɔyi̍ ɔnɔ̄nyā ge̍ chikpo̍
Anywhere	ba̍la ɛbɛha̍-ɛbɛha̍ 
beak	ͻkͻ
beans	eje
beautiful lady  	omgbonya
beauty  	a̍cha̍ānyā 
"beauty, applealing to sight"	ogeyi
because his own is not alive again  	"Wu̍chē oji̍ nɛ,  yī nū e̍ i̍ hɔ̄leyī gɛ ni̍"
because of how  	Wu̍chē lɔkɔ
because of what?	wu̍chē oji̍ nɛ?
because of what?	Wu̍chē oji̍ ?
because of what?	 wu̍chē oji̍ nɛ?
become	pīya
before before	gbi̍chɛ-gbi̍chɛ
before me	yɔbū de u
beg 	ra̍ābɔ̄
beginning	owu̍tu
behave  	yɛ̍ɛ̄lā
behind that one 	La okwi̍ihi yī ɔla̍ā
believe  	chɛ̄ku
believe in  her 	chɛ̄ku ɔ̍.
believe in  him 	chɛ̄ku ɔ̍.
believe in me	chɛ̄ku 
bell	ata
belly	lίpύ
better place    	ɛbɛ ɔlamu-ɔlamu
Bible	Īpū Yī Ɔwɔ
bickity 	yejẻ
big one 	ɔnɔ̄kɔ̄kū
big visitors	āchɔga ɔnɔ̄kɔ̄kū
bigger	gɔ̄ga
bird	ágbána
black	obi
blind	priyī
boat	wɔwu̍
body	bi̍īyē
book	īpū
born during war 	omgbadrewu
bottle  	yēkpē
bottle	yēkpē
boundary	ɛji
bread	ibrɛ̍ɛdi
break down	gbo tū ajɛ 
breast	āmɛ̄
brighter place	ɛbɛ ɔlɛgēdēgēdē
broald day-light	ɛbɛ ɔlɛgēdēgēdē
brukutu 	yejẻ
build	gwo̍
build house 	gwo̍ Ipu̍nu̍ 
build house 	gwo̍ u̍nu̍
burn up 	wɔla̍ ē hunū
but if anyone does something wrong  	Ɔ̄chɛ ɔha̍ ge̍ chī yɛ̍ɛ̄lā ɔdwɔ̄bi̍
calabash    	ogo
call them   	hī wā ɛra̍
call them to that wedding   	hī wā ɛra̍ ga ɔngrɛ̄ba̍ ɔla̍ā.
call them to wedding    	hī wā ɛra̍ ga ɔngrɛ̄ba̍
came and stood among them   	wā ge̍ rɛ abɔ̍ɔ la olo̍ōlo̍ yī wā
can contain one 	ē  gēē tū ūkpo̍he ē mɛ̍
canee rat   	obίjό
canoe   	wɔwu̍
can't look after it 	deyīrɛ ɔ̍ mɛ ni̍
can't watch ove it  	deyīrɛ ɔ̍ mɛ ni̍
certificate 	lɛhu̍ īpū
charcoal	ibi
chief 	ochwole
chief priests   	alɛhu̍ aligbe
chiefs  	 ɛgabɔ̄
child of God 	Ɔyi̍ yī Ɔwɔ
Christian affection 	ɔlɛyaya tāa ɔ̍nyīmɔ̄chɛ
church  	I̍kɔ̍ɔbahɛ
church leaders	alɛhu̍ I̍kɔ̍ɔbahɛ
clean	cha̍ri̍cha̍ri̍
cloth	Ɛjā otūlibi̍īyē
cloth	ālū
come	yewā
come back	 ku̍chē wa̍ 
comfort zone	ebeku
complete	gɔ̄grāa
complete	gɔ̄grāa
completely	gɔ̄grāa krididi
conclusion	Ɔchlɛhu̍ 
conderm 	chāajɛ
continue	yɛ̍ gāa iyɔ̄bū iyɔ̄bū 
cooking place	achͻ ͻlá
country	ɔcha
cow	egedebi̍ya̍ 
Crucify him	De ɔ̍ gwōba̍ la ɔchi̍ ɔhrɛ̍ɛpa 
cry	drɛ̄ɛgba
cryfish	ãbâdâ
crying	drɛ̄ɛgba
cuting grass	obijό
dance	ējē
dancing group	akatáaka
Dark place	Ɛbɛ odobū
Dark place	ɛbɛ odobū
David	Ide̍bīidi
David was Solomon's father	Ide̍bīidi ma Iso̍lōmɔn
death	ɔpīyaku̍
desert	lipu̍ a̍chi̍ chukuru
desires	 chikpo̍ la ɔyɔ̍ɔ̄ya̍
destroy	chāajɛ
destroy completely	chāajɛ ligbo̍-ligbo̍
devil	Ɔngūwɛ̄gā
dew	yẻbύ
die	pīyaku̍
disciples	a̍chi̍kpo̍
Discourage	hɛ ̍ bwob̍ wo ̍ ni
disgrace	liwēyī
divide themselve into two	de iyī wā kɔ̄ ɛpa
do	 ya̍
do anything	ya̍ ɛlāha̍-ɛlāha̍
do good	yɛ̍ɛ̄lā ɔnɛ̄ɛhɛhi
Do not be afraid	Ala̍ e̍e tūuhwi ni̍!
do not believe people who say	Ala̍ e̍e chɛ̄ku āchɛ  nīi ka
Don't be discouraged	A ā chī de hɛ ̍ bwob̍ wo ̍ ni
doubt	ta̍ahu̍ 
drum	ύba
dust	obubu
each other	ɔ̍nyīnū
ear	wͻrͻ
early  morning	 la obūrɔ̍ɔ̄chī
early in the morning	La eyī rwirwi
early in the morning on sunday	La obūrɔ̍ɔ̄chī yī Ɔ̄chī I̍kɔ̍ɔbahɛ
eat food	re̍ ojōre̍
edible food	ojōre̍ oro̍ōre̍
elder	ͻnyáku
elders	Anyāku̍
elephant	inyi
elge of a hole	oko̍o yī wɔ̄gɔ̄
end	chlɛhu̍
endurance	ɔtū ɔmɔ̄mla
endure	mlɔtū
enemy	Oluji
even if	O̍ ge̍ ro̍ōre̍ka
evening	ͻnɛ
evening	Ɔ̄nɛ̄ 
everlasting life	ɔhɔ̄leyī i̍mɔ̄mɛni̍
everybody	Ɔ̄chɛ-mɔ̄chɛ
eye	īkprī
eye	ikprĭyĭ
face	eyi
faith	ɔtū ode che Ɔwɔ ochōche
family	wɔma
father	adã
feet	a̍pa̍atīkpo̍
fight	ύnu
finger	ayi̍kābɔ̄ 
finish	kwɛ̍ɛjī 
finished	kwɛ̍ɛjī 
finished all	kwɛ̍ɛjī wa̍a̍
fire	ɔla̍
first	ɔrāarāa
first miracle	 yɛ̍ɛ̄lā ɔlɛbɛ̍bi̍ ɔrāarāa
flower	ukpo ͻchi
follow	ku
follow you	yɛ bal̍ a wɔ
food	ojōre̍
foolishness	i̍bobo
fourty years	lɛ̍yi̍ ohu ɛpa
fowl	olibobo
frog	ɛdu
from	bū
from God	bū la abɔ̄ Ɔwɔ
from his hand	gala abɔ̄ yī nū
from that place	"Bū la ɛbɛ ɔla̍ā,"
from that point	"Bū la ɛbɛ ɔla̍ā,"
from that talk	bū la Lɛlā ɔla̍ā
from the beginning	bū la owu̍tu
from the beginning	La owu̍tu
from the family	bū la wɔma
from the family of ogar	bū la wɔma yī ogar
from there	Bū la ɛbɛ ɔla̍ā
from this road	Bū la ɔpɔ̄pū nūma̍
fruit	ukpo ͻchi
fufu	wͻnã
furtune telling	ɛbã
gatekeeper	odeyīrɛ oko̍prīinu
gather together	grēeyī gblāa abɔ̍ɔ
get up	Nīichō!
"gift, one who give"	Odey
girl	ɔyi̍ ɔnɔ̄nyā
give glory to God	  de rīgā ke̍ke̍ni̍ de Ɔwɔ
glory	rīgā
go	pīya
go back home	ku̍chē pīya yī wɔlɛ̍
go out	ga ngmɛ̍ɛchɛ
go quickly	pīya ngla̍ gāa
goat	yɛwύ
God	Ɔwɔ
God gave	Ɔwɔ de
God is bigger	Ɔwɔ gɔ̄ga
God is love	Ɔwɔ - ɔhɔtū nɛ
God said	Ɔwɔ ka
Godliness	lɛlā yī Ɔwɔ ɔyɔ̍ɔ̄ya̍
good	ɔnɛ̄ɛhɛhi
good and bad	ɔnɛ̄ɛhɛhi ba̍la ɔbiɔbi
good evening!	nɔ̍bɛ Ɔ̄nɛ̄! (Respond: nɔ̍bɛ Ɔ̄nu̍)
Good is more than	Ɔwɔ gɔ̄ga
good morning	gbɔlɛhi
good people	āchɛ ɔnɛ̄ɛhɛhi
goodness	lehi
goodness	lɛhi
grave	u̍nwɔ̍wu̍
great honour	rīgā ɔnɔ̄kɔ̄kū
great respect	rīgā ɔnɔ̄kɔ̄kū
guinea worm	igbátɛ
gun	oloόbahe
gun powder	obi
had become	pīya
hammed robbers	okrōkpō
happiness	ɔwɔ̄wīyā
hare	ͻga
has become	de pīya
has finish	de kwɛ̍ɛjī
has finished	de kwɛ̍ɛjī
has finished all	de kwɛ̍ɛjī wa̍a̍
hate	ta̍ ɔ̄ anyī